1111111111111111111111111111111111111111111
1C000000000000000000000000C00000000000000C1
1000000011111111111110000000000000000000001
100C00000100000000000100000C000000000000001
100000001000000C000001000000000000C00000001
1000000010000000000000011111111000000000001
1C000000010000000000000000000000000C0000001
1111111001000000000000000000000000000000001
1C000000000000000C0000000C00000000000000001
1000000000000000000000000000000000000000001
100000000C000000000000000000C00000000000001
10000000000000000000000000000000000000000E1
1000000000000000000000000000000000000000001
100000000000C000000000000000000C00000000001
100C000000000000000000000000000000000000001
100000000000000000000000000C000000000000001
100000C000000000000000000000000000000000001
100000000000000000C000000000000000000000001
1000000000000000000000000000000000000000001
100000000000000000000000000C000000000000001
1C00000000000000000000000000000000000000001
1000000000000000000000000000000000000000001
1C00000000000000000000000000000000000000001
1P000000000000000000000000000000000000000C1
1111111111111111111111111111111111111111111