111111111111111111111111111111
1000000000000C00000000C0000001
1110C000000C0000000C0000000111
1111000000C0000001111100000001
1E0000011111111100000001111001
111100000000C11100000111000001
100P00111111111111100000000C01
111111111111111111111111111111