1111111111111111111111111111111111111111111111111111111111111111111111111111111111111111111111111111
1000000000000000000000000000000000000000000000000000000000000000000000000000000000000000000000000001
1000000011111111111110000000000000000000000000000000000001111111111110000000000000000000000000000001
100000000100000000000100000000000E000000000000000000000000000000000000000000000000000000000000000001
1000000010000000000001000000000000000000000000000000000000000000000000000000000000000000000000000001
1000000010000000000000011111111000000000000000000000000000000000000000000000000000000000000000000001
1000000001000000000000000000000000000000000000000000000000000000000000000000000000000000000000000001
1111111001000000000000000000000000000000000000000000000000000000000000000000000000000000000000000001
1000000000000000000000000000000000000000000000000000000000000000000000000000000000000000000000000001
1000000000000000000000000000000000000000000000111110000000000000000000000000000000000000000000000001
1000000000000000000000000000000000000000000000111110000000000000000000000000000000000000000000000001
1000000000000000000000000000000000000000000000111110000000000000000000000000000000000000000000000001
100000000000C000000000000C00000000000000000000111110000000000000000000000000000000000000000000000001
1000000000000000000000000000000000000000000000111110000000000000000000000000000000000000000000000001
1000000000000000000000000000000000000000000000000000000000000000000000000000000000000000000000000001
1000000000000000000000000000000000000000000000000000000000000000000000000000000000000000000000000001
1000000000000000000001111111111111111111111111111111111111111111111110000000000000000000000000000001
100000000000000000000000000000000000000000000C000111111111111111111111111000000000000000000000000001
1000000000000000000000000000000000000011111111111111111111111100000000000000000000000000000000000001
1000000000000000000000000000000000000000000000000000000000000000000000000000000001111110000000000001
10000000000000P0000000000000000000000000000000000000000000000000000000000000000001111110000000000001
1000000000000000000000000000000000000000000000000000000000000000000000000000000001111110000000000001
100000000000000000000000000C000000000000000000000000000000000000000000000000000001111110000000000001
10000000000000000000000000000000000000000000000000000000000000000000000000000000011111100000000000C1
1000000010000000000000011111111000000000000000000000000000000000000000000000000001111110000000000001
1000000001000000000000000000000000000000000000000000000000000000000000000000000001111110000000000001
1111111001000000000000000000000000000000000000000000000000000000000000000000000001111110000000000001
1000000000000000000000000000000000000000000000000000000000000000000000000000000001111110000000000001
1000000000000000000000000000000000000000000000111110000000000000000000000000000001111110000000000001
1000000000000000000000000000000000000000000000111110000000000000000000000000000001111110000000000001
1000000000000000000000000000000000000000000000111110000000000000000000000000000000000000000000000001
100000000000C000000000000C00000000000000000000111110000000000000000000000000000000000000000000000001
1000000000000000000000000000000000000000000000111110000000000000000000000000000000000000000000000001
1000000000000000000000000000000000000000000000000000000000000000000000000000000000000000000000000001
1000000000000000000000000000000000000000000000000000000000000000000000000000000000000000000000000001
1000000000000000000001111111111111111111111111111111111111111111111110000000000000000000000000000001
100000000000000000000000000000000000000000000C000111111111111111111111111000000000000000000000000001
1000000000000000000000000000000000000011111111111111111111111100000000000000000000000000000000000001
1000000000000000000000000000000000000000000000000000000000000000000000000000000000000000000000000001
1000000000000010000000000000000000000000000000000000000000000000000000000000000000000000000000000001
1000000000000000000000000000000000000000000000000000000000000000000000000000000000000000000000000001
100000000000000000000000000C000000000000000000000000000000000000000000000000000000000000000000000001
10000000000000000000000000000000000000000000000000000000000000000000000000000000000000000000000000C1
1111111111111111111111111111111111111111111111111111111111111111111111111111111111111111111111111111